XXXXXXXXXXXXXXXXXXXXXXXXXXXXXXXXXXXXXXXXXXXXXXXXXXXXXXXXXXXXXXXXXXXXXXXXXXXXXXX
XsX     X             X X           X   X   X       X                 X       X
X X X XXX XXXXXXXXX X X X XXX XXXXX X X X X X X XXX X XXXXXXXXXXX X X XXX XXX X
X X X     X       X X   X   X X     X X X X   X   X X X         X X X   X X   X
X XXXXXXXXX XXXXX X XXX XXX X XXXXX X X X XXXXXXX X XXX XXXXXXX XXX XXX X X XXX
X X       X X   X   X   X   X     X X X X X       X     X     X X   X     X X X
X X XXXXX X X X XXX XXXXX XXXXXXX X X X X X XXXXXXXXXXXXXXX X X X XXXXXXXXX X X
X   X     X   X X   X   X     X   X   X X X     X     X     X X X         X X X
XXXXX XXXXX XXX X XXX X XXX XXX XXXXXXX XXX XXX X XXX X XXX XXX XXXXXXXXX X X X
X   X   X   X X X X   X     X   X   X X   X   X     X X X   X   X     X   X   X
X XXXXX X XXX X XXX XXXXXXXXX XXX X X XXX XXXXXXXXX X X XXXXX XXX XXX X XXXXX X
X   X   X X   X           X   X   X   X X       X   X X       X     X X X     X
XXX X XXX X XXXXXXXXXXX XXX XXX XXXXX X XXXXXXX X XXX X XXXXXXX XXX X X XXXXX X
X   X X     X     X     X   X     X     X       X   X X   X     X   X X     X X
X XXX XXXXXXX XXX X XXXXX XXX XXX XXXXX X XXXXXXXXX X XXX XXXXX X XXX X XXX X X
X   X   X     X X X     X   X X   X   X X X       X X X       X X X   X   X X X
X X XXX X XXXXX X XXXXX XXX X X XXX X XXX X X XXX XXX XXXXXXX X X X XXXXXXX X X
X X   X X   X   X X     X   X X X   X   X X X   X   X     X   X X X X     X X X
X X XXX X X X X X XXXXX X XXXXX X XXXXX X XXXXX XXX X XXX X XXXXX X XXX X X X X
X X X   X X X X X X   X X     X X   X X   X     X X X X   X   X   X   X X   X X
X X X XXXXX X X X X X XXXXXXX X XXX X XXXXX XXXXX X XXX XXXXX X XXXXX X XXXXX X
X X         X X     X         X             X           X       X       X    fX
XXXXXXXXXXXXXXXXXXXXXXXXXXXXXXXXXXXXXXXXXXXXXXXXXXXXXXXXXXXXXXXXXXXXXXXXXXXXXXX