XXXXXXXXXXXXXXXXXXXXXXXXXXXXXXXXXXXXXXXXXXXXXXX
XSX   X   X   X       X     X X   X           X
X X X XXX X X X X XXX X X XXX X X X XXXXXXXXX X
X   X   X   X   X X X X X   X   X X X X       X
XXXXXXX X XXXXXXX X X X XXX XXXXX X X X XXXXX X
X   X   X X   X X X X X   X   X X X   X X   X X
X X X XXX X X X X X X XXX XXX X X XXX X X X X X
X X X X     X X X X   X   X X X     X X X X X X
X X X XXXXXXX X X XXXXX XXX X XXXXX X X X X XXX
X X X   X       X     X   X X   X   X X   X   X
XXX XXX XXXXXXXXXXXXX XXX X XXX X XXXXXXXXXXX X
X   X   X     X     X         X X     X       X
X XXX XXX XXX X XXX XXXXXXXXXXX XXXXX X XXXXX X
X         X     X               X       X    FX
XXXXXXXXXXXXXXXXXXXXXXXXXXXXXXXXXXXXXXXXXXXXXXX